PID_Line_Follower	KEYWORD1

PID	KEYWORD2
ComputeSpeed	KEYWORD2
setMode	KEYWORD2
getKi	KEYWORD2
getKp	KEYWORD2
getKd	KEYWORD2
getSetpoint	KEYWORD2
setTunings	KEYWORD2
SetSpeed	KEYWORD2
setKp	KEYWORD2
setKi	KEYWORD2
setKd	KEYWORD2
setSetpoint	KEYWORD2
SetMode	KEYWORD2
setSampleTime	KEYWORD2
SpeedPWM	KEYWORD2

AUTOMATIC	LITERAL1
MANUAL	LITERAL1
Speed	LITERAL1